#######
#     #
# $ @ #
#  .  #
#######
